11111111111E111
00GG0000001G001
0GGGGG000011000
000111111111111
000000000001000
0GGGGG111111111
0G0100010001000
10G10001000D001
100000010001000
111111111111010