01111111111111E
00000000001G001
000000000011000
000000000001000
000000000001000
000000000001000
0G0100010001000
00G100010001000
000000010001000
00D000010001G11
011111111111001